========== =========
=                  =
==========........ =
....................
=    ===============
=           g      =
=== ...... ==== ====
=== ====== ==== ====
=       G          =
=== ======         =
....................
=    ===============
=        g         =
===             ====
=== ====== ==== ====
=   .............  =
==========         =
........G...........
=    ======== ======
=                  =
